1111111111111111111111111
1000000000000100000000001
1000000000000100000000001
1000000000000100000000001
1000000000000100000000001
1000000000000100000000001
1000000000000100000000001
1000000000000100000000001
1000000000000100000000001
1000000000000100000000001
1000000000000100000000001
1000000000000100000000001
1000000000011111000000001
1000000000110001000000001
1000000001100001110000001
1000000011000001000000001
1000000110000000000000001
1000000000000000000000001
1000000000000000000000001
1000000000000000000000001
1000000000000000000000001
1000000000000000000000001
1000000000000000000000001
1000000000000000000000001
1111111111111111111111111